3 3 3 3 3 3 3 3 3 3 3 3 3 3 3 3 3 3 3 3 3 3 3 3 3 3 3 3 3 3 3 3 3 3 2 2 2 2 2 2 2 2 2 2 2 2 2 2 3 3 3 3 3 3 3 3 3 3 3 3 3 3 3 3 3 3 3 3 3 3
3 3 0 0 0 0 0 0 3 0 0 0 3 0 0 0 0 0 0 3 3 3 3 3 3 3 3 3 3 3 3 3 3 3 2 2 2 2 2 2 2 2 2 2 2 2 2 2 3 3 3 3 3 3 3 3 3 3 3 3 3 3 3 3 3 3 3 3 3 3
3 0 0 0 0 0 0 0 3 0 0 0 3 0 0 0 0 0 0 0 3 3 3 0 0 0 0 0 0 0 0 0 3 3 2 2 0 0 0 0 0 0 0 0 0 0 0 0 0 0 0 0 0 0 0 0 0 0 0 0 6 0 0 0 0 0 0 0 3 3
3 0 0 0 0 6 0 0 3 3 0 3 3 0 0 0 0 0 0 0 3 3 3 0 0 0 0 3 3 3 0 0 3 3 2 2 0 0 2 2 2 0 0 0 0 0 2 2 3 3 3 3 3 3 3 3 3 3 3 3 3 3 3 3 3 3 3 0 3 3
3 0 0 4 0 0 0 0 0 5 0 5 0 0 0 0 0 4 0 0 3 3 3 0 0 0 0 3 0 3 0 0 3 3 2 2 0 0 2 4 2 0 0 6 0 0 2 2 3 3 0 0 0 0 6 0 0 0 0 0 0 0 0 0 0 0 0 0 3 3
3 3 0 0 0 0 0 0 0 0 0 0 0 0 0 6 0 0 0 0 3 3 3 0 6 0 0 3 3 3 0 0 3 3 2 2 0 0 2 2 2 0 0 0 0 0 2 2 3 3 0 3 3 3 3 3 3 3 3 3 3 3 3 3 3 3 3 3 3 3
3 0 0 0 0 0 0 0 0 0 0 0 0 0 0 0 0 0 0 0 3 3 0 0 0 0 0 0 0 0 0 0 3 3 2 2 0 0 0 0 0 0 0 0 0 0 2 2 3 3 0 0 0 0 0 0 0 0 0 0 0 0 0 0 0 0 0 0 3 3
3 0 0 0 0 0 0 0 0 6 0 0 0 0 0 0 0 0 0 0 3 3 0 0 0 0 0 0 0 0 0 0 2 2 2 2 0 6 0 0 0 0 0 0 0 0 2 2 3 3 3 3 3 3 3 3 3 3 3 3 3 3 3 3 3 3 3 0 3 3
3 0 0 0 0 0 0 0 0 0 0 0 0 0 0 0 0 0 0 0 3 3 0 0 0 6 0 0 0 0 0 0 2 2 2 2 0 0 0 0 0 0 0 0 0 0 2 2 3 3 0 0 0 0 0 0 0 0 0 0 0 0 0 0 0 0 6 0 3 3
3 0 0 0 0 0 0 0 0 0 0 0 0 0 0 0 0 0 0 3 3 3 0 0 0 0 0 0 0 0 0 0 3 3 2 2 0 0 0 0 0 6 0 0 0 0 2 2 3 3 0 3 3 3 3 3 3 3 3 3 3 3 3 3 3 3 3 0 3 3
3 0 0 0 0 0 6 0 0 0 0 0 0 0 0 4 0 0 0 0 3 3 0 0 0 0 0 0 6 0 0 0 3 3 2 2 0 0 0 0 0 0 0 0 0 0 2 2 3 3 0 0 0 0 0 0 0 0 6 0 0 0 0 0 0 0 0 0 3 3
3 0 0 0 0 0 0 0 0 0 0 0 0 0 0 0 0 6 0 0 3 3 0 0 0 0 0 0 0 0 0 0 3 3 2 2 0 0 0 0 0 0 0 0 0 0 2 2 3 3 3 3 3 3 3 3 3 3 3 3 3 3 3 3 3 3 3 0 3 3
3 0 0 0 0 0 0 0 0 0 0 0 0 0 0 0 0 0 0 0 3 3 3 0 0 0 0 0 0 0 0 0 3 3 2 2 0 0 0 0 0 0 0 0 6 0 2 2 3 3 0 0 0 0 0 6 0 0 0 0 0 0 0 0 0 0 0 0 3 3
3 3 0 0 0 0 0 0 5 0 0 0 5 0 0 0 0 0 0 3 3 3 3 0 0 6 0 0 0 0 0 0 3 3 2 2 0 0 0 6 0 0 0 0 0 0 2 2 3 3 0 3 3 3 3 3 3 3 3 3 3 3 3 3 3 3 3 0 3 3
3 3 3 3 3 3 3 3 3 0 0 0 3 3 3 3 3 3 3 3 3 3 3 0 0 0 0 0 0 0 0 0 3 3 2 2 0 0 0 0 0 0 0 0 0 0 2 2 3 3 0 0 0 0 0 0 0 0 0 0 0 0 6 0 0 0 0 0 3 3
3 3 3 3 3 3 3 3 3 0 0 0 3 3 3 3 3 3 3 3 3 3 3 0 0 0 0 0 0 0 0 0 3 3 2 2 0 0 0 0 0 0 0 0 0 0 2 2 3 3 3 3 3 3 3 3 3 3 0 0 3 3 3 3 3 3 3 3 3 3
3 3 3 3 3 3 3 3 3 0 0 0 3 3 3 3 3 3 3 3 3 3 3 3 3 3 3 3 0 0 3 3 3 3 2 2 2 2 0 0 2 2 2 2 2 2 2 2 3 3 0 0 0 0 0 0 0 0 0 0 0 0 0 0 0 0 0 4 3 3 
3 3 3 3 3 3 3 3 3 0 0 0 3 3 3 3 3 3 3 3 3 3 3 3 3 3 3 3 0 0 3 3 3 3 2 2 2 2 0 0 2 2 2 2 2 2 2 2 3 3 0 0 0 0 4 0 0 6 0 0 0 0 0 4 0 6 0 0 3 3 
3 3 3 0 0 0 0 0 0 0 0 0 0 0 0 0 0 0 3 3 3 3 3 3 3 3 3 3 0 0 3 3 3 3 2 2 2 2 0 0 2 2 2 2 2 2 2 2 3 3 4 0 0 0 0 0 0 0 0 0 0 4 0 0 0 0 0 4 3 3 
3 3 3 0 0 0 0 0 0 0 0 0 0 0 0 0 0 0 3 3 3 2 2 2 2 2 2 2 0 0 2 2 2 2 2 2 2 2 0 0 2 2 2 2 2 2 2 2 3 3 3 3 3 3 3 3 3 3 3 3 0 3 3 3 3 3 3 3 3 3
3 3 3 0 0 1 1 1 0 0 0 6 0 1 1 1 0 0 3 3 3 2 2 2 2 2 2 2 0 0 2 2 2 2 2 2 2 2 0 0 2 2 2 2 2 2 2 2 3 3 3 3 3 3 3 3 3 3 3 3 0 0 3 3 3 3 3 3 3 3
3 3 3 0 0 1 1 1 0 0 0 0 0 1 1 1 0 0 3 3 3 2 2 0 0 0 0 5 0 0 2 0 0 0 0 0 0 5 0 0 5 0 0 0 0 0 2 2 3 3 4 4 4 4 4 4 4 4 4 0 0 0 0 4 4 4 4 4 3 3
3 3 3 0 0 1 1 1 0 0 0 0 0 1 1 1 0 0 3 3 3 2 2 0 0 0 0 0 0 0 0 0 0 0 0 0 0 0 0 0 0 0 0 0 0 0 2 2 3 3 4 4 4 4 4 4 4 4 0 0 0 6 0 0 4 4 4 4 3 3
3 3 3 0 0 0 0 0 0 0 0 0 0 0 0 0 0 0 3 3 3 2 2 0 0 0 0 0 0 0 0 0 0 0 0 0 0 0 0 0 6 0 0 0 0 0 2 2 3 3 4 4 4 4 4 4 4 0 0 0 0 0 0 0 4 4 4 4 3 3
3 3 3 0 0 0 0 0 6 0 0 0 0 0 0 0 0 0 3 3 3 2 2 0 0 0 0 0 6 0 0 0 0 0 0 0 0 0 0 0 0 0 0 0 0 0 2 2 3 3 4 4 4 4 4 4 0 0 6 0 0 0 0 0 4 4 4 4 3 3
3 3 3 0 0 0 0 0 0 0 0 0 0 0 6 0 0 0 3 3 3 2 2 0 0 0 0 0 0 0 0 0 0 6 0 0 0 0 0 0 0 0 6 0 0 0 2 2 3 3 4 4 4 4 4 4 0 0 0 0 0 0 0 0 4 4 4 4 3 3
3 3 3 0 0 0 0 0 0 0 0 0 0 0 0 0 0 0 3 3 3 2 2 0 0 0 0 0 0 0 0 0 0 0 0 0 0 0 0 0 0 0 0 0 0 0 2 2 3 3 4 4 4 4 4 0 0 0 0 0 0 0 0 0 4 4 4 4 3 3
3 3 3 0 0 6 0 0 0 0 0 0 0 0 0 0 0 0 3 3 3 2 2 0 0 0 6 0 0 0 0 0 0 0 0 0 0 0 0 0 0 0 0 0 0 0 2 2 3 3 4 4 4 4 0 0 0 0 0 0 0 6 0 0 4 4 4 4 3 3
3 3 3 0 0 0 0 0 0 0 0 0 0 0 0 0 0 0 3 3 3 2 2 0 0 0 0 0 0 0 0 0 6 0 0 0 0 0 0 0 0 0 0 0 0 0 2 2 3 3 4 4 4 0 0 0 0 0 0 0 0 0 0 0 4 4 4 4 3 3
3 3 3 3 3 3 3 3 3 0 0 0 3 3 3 3 3 3 3 3 3 2 2 0 0 0 0 0 0 0 0 0 0 0 0 6 0 0 0 0 0 0 0 0 0 0 2 2 3 3 4 4 4 0 0 0 0 6 0 0 0 0 0 0 4 4 4 4 3 3
3 3 3 3 3 3 3 3 3 0 0 0 3 3 3 3 3 3 3 3 3 2 2 0 0 0 0 0 0 0 0 0 0 0 0 0 0 0 0 0 0 0 0 0 0 0 2 2 3 3 4 4 4 0 0 0 0 0 0 0 0 0 0 0 4 4 4 4 3 3
3 3 4 4 4 4 4 3 3 0 0 0 3 3 4 4 4 4 4 3 3 2 2 0 0 0 0 0 0 0 0 0 0 0 0 0 0 0 0 0 0 0 0 0 0 0 2 2 3 3 3 3 3 0 0 0 0 0 0 0 0 0 0 0 3 3 3 3 3 3
3 4 4 4 4 4 4 4 4 4 0 0 4 4 4 4 4 4 4 4 3 2 2 0 0 0 0 0 0 0 0 6 0 0 0 0 0 0 0 0 0 0 0 0 0 0 2 2 3 3 3 1 1 1 1 1 1 1 0 1 1 1 1 1 1 1 3 3 3 3
4 4 4 4 4 4 4 4 4 4 4 0 0 4 4 4 4 4 4 4 4 2 2 0 0 0 0 0 0 0 0 0 0 0 0 0 0 0 0 0 0 0 0 0 0 0 2 2 3 3 3 1 1 1 1 1 1 1 0 1 1 1 1 1 1 1 3 3 3 3
4 4 4 4 4 4 4 4 4 4 4 0 0 4 4 4 4 4 4 4 4 2 2 0 0 6 0 0 0 0 0 0 0 0 0 0 0 0 0 0 0 0 0 6 0 0 2 2 3 3 3 3 3 0 0 0 0 0 0 0 0 0 0 0 3 3 3 3 3 3
4 4 4 4 4 4 4 4 4 0 0 0 0 0 0 0 4 4 4 4 4 2 2 0 0 0 0 0 0 0 0 0 0 0 0 0 0 0 0 0 0 0 0 0 0 0 2 2 3 3 0 0 0 0 0 6 0 0 0 0 0 0 0 0 0 0 0 0 3 3
4 4 4 4 4 4 4 0 0 0 0 0 0 6 0 0 4 4 4 4 4 2 2 0 0 0 0 0 0 0 0 0 6 0 0 0 0 0 0 0 0 0 0 0 0 0 2 2 3 3 0 0 0 0 0 0 0 0 0 0 0 0 0 0 0 0 0 0 3 3
4 4 4 4 3 0 0 0 6 0 0 0 0 0 0 3 4 4 4 4 4 2 2 0 0 0 0 0 0 0 0 0 0 0 0 0 0 0 0 0 0 0 5 0 0 5 2 2 3 3 0 0 0 0 0 0 0 0 0 0 0 0 0 6 0 0 0 0 3 3
3 3 3 3 3 0 6 0 0 0 0 0 0 0 0 3 3 3 3 3 3 2 2 2 2 2 2 2 2 2 2 2 2 2 2 2 2 2 2 2 2 2 2 0 0 2 2 2 3 3 0 0 0 0 0 0 0 0 0 0 0 0 0 0 0 0 0 0 3 3
3 3 3 3 0 0 0 0 0 0 0 6 0 0 0 0 0 3 3 3 3 2 2 2 2 2 2 2 2 2 2 2 2 2 2 2 2 2 2 2 2 2 2 0 0 2 2 2 3 3 3 3 3 3 3 3 3 0 0 0 3 3 3 3 3 3 3 3 3 3
3 3 3 0 0 0 0 0 0 0 0 0 0 0 0 0 0 0 3 3 3 3 4 4 4 4 4 4 4 4 4 4 4 4 4 4 4 4 4 4 4 4 4 0 0 4 4 4 2 2 2 2 2 2 2 2 2 0 0 0 2 2 2 2 2 2 2 2 2 2
3 4 3 3 3 3 3 3 3 2 0 2 3 3 3 3 3 3 3 3 3 3 4 4 4 4 0 0 0 0 0 0 0 0 0 0 0 0 4 4 4 4 4 0 0 4 4 4 2 2 2 2 2 2 2 2 2 0 0 0 2 2 2 2 2 2 2 2 2 2
3 3 3 3 3 3 3 3 3 2 0 2 2 2 3 3 3 3 3 3 3 3 4 4 4 0 0 0 0 0 0 0 6 0 0 0 0 0 0 4 4 4 4 0 0 4 4 4 2 2 2 2 2 2 2 2 2 0 0 0 2 2 2 2 2 2 2 2 2 2
3 3 3 2 2 2 2 2 2 2 0 0 0 2 3 3 3 3 3 3 3 3 4 4 0 0 0 4 4 4 4 4 4 4 4 4 4 0 6 0 4 4 4 0 0 4 4 4 2 2 2 2 2 2 2 2 2 0 0 0 2 2 2 2 2 2 2 2 2 2
3 3 3 2 0 0 0 0 0 0 0 2 0 2 3 3 3 3 3 3 3 3 4 0 6 0 4 4 4 4 4 4 4 4 4 4 4 4 0 0 0 4 4 0 0 4 4 4 2 2 2 2 2 2 2 2 2 0 0 0 2 2 2 2 2 2 2 2 2 2
3 3 3 2 0 2 2 2 2 2 2 2 0 2 3 3 3 3 3 3 3 3 0 0 0 4 4 4 2 2 2 2 2 4 4 4 4 4 4 0 0 0 4 0 0 4 4 4 2 2 2 2 2 2 2 2 2 0 0 0 2 2 2 2 2 2 2 2 2 2
3 3 3 2 0 6 0 0 0 0 0 0 0 2 2 2 2 2 2 2 2 5 0 0 4 4 4 4 2 0 0 0 2 4 4 4 4 4 4 4 0 6 0 0 0 4 4 4 2 2 0 0 0 0 0 0 0 0 0 0 0 0 0 0 0 0 0 0 2 2
3 3 3 2 2 2 2 0 2 2 2 6 2 2 2 0 2 0 0 0 0 0 0 0 0 0 0 0 0 0 0 0 2 4 4 4 4 4 4 4 0 0 0 0 0 4 4 4 2 2 0 0 0 0 0 0 0 6 0 0 0 0 0 0 0 0 0 0 2 2
3 3 3 3 3 3 2 0 2 3 2 0 2 4 2 0 2 0 2 2 2 5 0 0 4 4 4 4 2 0 0 0 2 4 4 4 4 4 4 0 0 0 4 0 0 4 4 4 2 2 0 0 0 0 0 0 0 0 0 0 0 0 0 0 0 0 0 0 2 2
2 2 2 2 2 2 2 0 2 2 2 0 2 2 2 0 2 0 2 3 3 3 0 0 0 4 4 4 2 2 2 2 2 4 4 4 4 4 0 0 0 4 4 0 0 4 4 4 2 2 0 0 0 0 0 0 0 0 0 0 0 0 0 6 0 0 0 0 2 2
2 0 0 0 0 0 0 0 0 0 0 0 0 0 0 0 2 0 2 3 3 3 4 0 0 0 4 4 4 4 4 4 4 4 4 4 4 0 0 0 4 4 4 0 0 4 4 4 2 2 0 0 1 1 1 1 0 0 0 0 0 1 1 1 1 0 0 0 2 2
2 2 2 2 0 2 2 2 2 2 2 0 2 2 2 2 2 6 2 3 3 3 4 4 0 0 0 4 4 4 4 4 4 4 4 4 0 6 0 4 4 4 4 0 6 4 4 4 2 2 0 0 1 1 1 1 0 0 0 0 0 1 1 1 1 0 0 0 2 2
2 0 0 0 0 2 3 3 3 3 2 0 2 3 3 3 2 0 2 3 3 3 4 4 4 0 0 0 0 0 6 0 0 0 0 0 0 0 4 4 4 4 4 0 0 4 4 4 2 2 0 0 1 1 1 1 0 0 0 6 0 1 1 1 1 0 0 0 2 2
2 0 2 2 2 2 3 3 3 3 2 0 2 2 2 2 2 0 2 3 3 3 4 4 4 4 0 0 0 0 0 0 0 0 0 0 4 4 4 4 4 4 4 0 0 4 4 4 2 2 0 0 1 1 1 1 0 0 0 0 0 1 1 1 1 0 0 0 2 2
2 0 2 3 3 3 3 3 3 3 2 0 0 0 0 2 2 0 2 3 3 3 4 4 4 4 4 4 4 4 0 0 4 4 4 4 4 0 0 0 0 0 0 0 0 4 4 4 2 2 0 0 0 0 0 0 0 0 0 0 0 0 0 0 0 0 0 0 2 2
2 0 2 2 2 2 2 2 2 2 2 0 2 2 2 2 2 0 2 3 3 3 4 4 4 4 4 4 4 4 0 0 4 4 4 4 4 0 0 5 0 0 0 0 0 4 4 4 2 2 0 0 0 6 0 0 0 0 0 0 0 0 0 0 0 0 0 0 2 2
2 0 0 0 0 0 0 0 0 0 0 0 2 3 3 3 2 0 2 3 3 3 4 4 4 4 4 4 4 4 0 0 4 4 4 4 4 4 4 4 4 4 4 0 0 4 4 4 2 2 0 0 0 0 0 0 0 0 0 0 6 0 0 0 0 0 0 0 2 2
2 0 2 2 2 2 2 2 2 2 2 2 2 2 2 2 2 0 2 3 3 3 4 4 4 4 4 4 4 4 0 0 0 0 0 0 0 0 0 0 6 0 0 0 0 4 4 4 2 2 0 0 0 0 0 0 0 0 0 0 0 0 0 0 0 6 0 0 2 2
2 0 0 0 6 0 0 0 0 0 0 0 0 0 0 0 0 0 2 3 3 3 4 4 4 4 4 4 4 4 0 0 0 0 0 6 0 0 0 0 0 0 0 0 0 4 4 4 2 2 2 2 2 2 2 2 2 2 2 2 2 2 2 2 2 2 2 2 2 2
2 2 2 2 2 2 2 2 2 2 2 2 2 2 2 2 2 2 2 3 3 3 4 4 4 4 4 4 4 4 4 4 4 4 4 4 4 4 4 4 4 4 4 4 4 4 4 4 2 2 2 2 2 2 2 2 2 2 2 2 2 2 2 2 2 2 2 2 2 2
